Final move, searched states: 66
######
# O###
##$###
#    #
#    #
#  ###
######

Move up
######
# _###
##o###
# $  #
#    #
#  ###
######

Move up
######
# _###
## ###
# o  #
# $  #
#  ###
######

Move up
######
# _###
## ###
#    #
# o  #
# $###
######

Move right
######
# _###
## ###
#    #
# o  #
#$ ###
######

Move down
######
# _###
## ###
#    #
#$o  #
#  ###
######

Move down
######
# _###
## ###
#$   #
# o  #
#  ###
######

Move left
######
# _###
## ###
# $  #
# o  #
#  ###
######

Move left
######
# _###
## ###
#  $ #
# o  #
#  ###
######

Move up
######
# _###
## ###
#    #
# o$ #
#  ###
######

Move left
######
# _###
## ###
#    #
#  o$#
#  ###
######

Move down
######
# _###
## ###
#   $#
#  o #
#  ###
######

Move right
######
# _###
## ###
#  $ #
#  o #
#  ###
######

Move right
######
# _###
## ###
# $  #
#  o #
#  ###
######

Move down
######
# _###
##$###
#    #
#  o #
#  ###
######

Took 14 steps in total.
  0.12s user 0.01s system 86% cpu 0.157 total
