Final move, searched states: 819
Move left
######
#O  ##
#$   #
##   #
###  #
#### #
####O#
######

Move down
######
#_o ##
#    #
#$   #
###  #
#### #
####O#
######

Move right
######
#_o ##
#    #
##$  #
###  #
#### #
####O#
######

Move down
######
#_o ##
# $  #
##   #
###  #
#### #
####O#
######

Move left
######
#_  ##
# o$ #
##   #
###  #
#### #
####O#
######

Move up
######
#_  ##
# o  #
## $ #
###  #
#### #
####O#
######

Move left
######
#_  ##
# o  #
##$  #
###  #
#### #
####O#
######

Move down
######
#_  ##
#  o #
##   #
##$  #
#### #
####O#
######

Move right
######
#_  ##
#  o #
##   #
###$ #
#### #
####O#
######

Move down
######
#_  ##
#  o #
## $ #
###  #
#### #
####O#
######

Move left
######
#_  ##
#    #
## o$#
###  #
#### #
####O#
######

Move down
######
#_  ##
#    #
## o #
### $#
#### #
####O#
######

Move up
######
#_  ##
#    #
## o #
###  $
#### #
####O#
######

Move up
######
#_  ##
#    #
## o #
### $#
####o#
####_#
######

Move up
######
#_  ##
#    #
## o #
###$o#
#### #
####_#
######

Move right
######
#_  ##
#    #
## oo#
##$  #
#### #
####_#
######

Move up
######
#_  ##
#    #
##$oo#
###  #
#### #
####_#
######

Move right
######
#_  ##
#  o #
#$  o#
###  #
#### #
####_#
######

Move down
######
#_  ##
#$ o #
##  o#
###  #
#### #
####_#
######

Move down
######
#_  ##
# $o #
##  o#
###  #
#### #
####_#
######

Move left
######
#_  ##
#  o #
##  o#
###  #
#### #
####_#
######

Move right
######
#_  ##
#  o #
## $o#
###  #
#### #
####_#
######

Move up
######
#_  ##
#  o #
## o #
###  #
#### #
####_#
######

Move right
######
#_  ##
# $o #
## o #
###  #
#### #
####_#
######

Move up
######
#_$ ##
# o  #
## o #
###  #
#### #
####_#
######

Move left
######
#$  ##
# o  #
## o #
###  #
#### #
####_#
######

Move left
######
#_  ##
#$o  #
## o #
###  #
#### #
####_#
######

Move down
######
#_  ##
# o  #
#$ o #
###  #
#### #
####_#
######

Move up
######
#_  ##
# o  #
##$o #
###  #
#### #
####_#
######

Move right
######
#_  ##
# oo #
#$   #
###  #
#### #
####_#
######

Move right
######
#_  ##
#$oo #
##   #
###  #
#### #
####_#
######

Move down
######
#$  ##
# oo #
##   #
###  #
#### #
####_#
######

Took 32 steps in total.
  0.25s user 0.06s system 98% cpu 0.314 total
